10
. . . . . . . . . +
. . . . . . . . .  
. . N . . . . . .  
. . . . @ . . . .  
. . . . . . . . .  
. . . . . . . . .  
. . . . . . . . .  
. . . . . . . . .  
. . . . . . . . .  
. . . . . . . . . +
x